111000100010110001101011111
111000100010110001111101011
111010100011110001101000111
111000100101010001110011111
111110100000010001101011111
111000100010111001110011101
111111100010110001101000011
111000100010110001011111101
111011100000110001101010111
111000100010101001111011110
111010100110000001101011111
111000100110101001010011111
111101100011010001110000111
111010100101110001111000011
111010100101011001110000111
111010100011110001111101000
111010100011111001110000101
111110100000010001111101011
111110100010011001101000111
111011100010110001101111000
111000100111010001110101011
111110100101000001010011111
111000100011010001101110111
111000100101010001111110011
111111100010110001011101000
111010100000101001110011111
111000100101111001010011110
111000100010011001110101111
111110100111010001101000011
111111100000010001101110011
111111100101010001110000011
111010100000110001101111011
111000100010111001101110011
111000100110010001111011101
111011100010110001111000101
111111100011110001101010000
111101100010111001110000011
111111100000010001110011101
111110100000111001010011101
111010100011101001111000110
111000100011010001110111101
111011100101000001110010111
111011100000110001111101010
111000100010101001110111011
111011100000111001110010101
111110100011000001101010111
111010100110000001111101011
111110100000010001011111101
111111100010011001110000101
111011100000010001110101111
111000100101010001011111110
111101100000110001111010011
111000100110111001010101011
111010100111110001011000101
111010100011110001000111101
111000100101110001111011010
111010100101110001000011111
111101100010110001011000111
111110100011101001010000111
111010100110101001011000111
111000100111010001101011110
111000100111110001010011101
111111100000110001101011010
111010100110111001101000011
111110100010101001111000011
111101100000010001111011110
111111100110000001101010011
111011100000010001101111110
111101100000011001110010111
111010100000011001101110111
111000100110101001111010011
111011100010110001000101111
111111100010110001000011101
111101100010000001110011111
111101100000110001010011111
111000100010111001011101110
111110100010101001000011111
111011100110010001101000111
111101100010110001111011000
111110100011010001101111000
111010100111101001110000011
111011100101110001111010000
111101100011000001010110111
111000100011010001111101110
111110100010011001111101000
111110100101010001011000111
111011100101010001110111000
111010100111110001101011000
111000100011110001101111010
111101100110011001010000111
111010100110111001000011101
111110100000101001111011010
111010100101110001011111000
111010100111011001110101000
111000100011101001110010111
111101100011111001010000110
111000100101111001110010011
111010100110011001111000101
111110100101000001111010011
111010100101111001011000110
111010100011000001110101111
111000100011110001111010101
111111100000010001011101110
111011100000101001111010110
111111100110101001010000011
111000100111110001101010011
111000100110111001101011010
111011100010000001110111101
111101100011010001111110000
111011100010111001110101000
111010100111000001110011101
111010100101011001111110000
111111100011010001110101000
111101100000010001110111011
111010100000110001011101111
111010100011111001101110000
111110100011010001111000101
111110100111000001010101011
111000100010011001111110101
111010100000110001111011101
111010100000111001110101011
111011100010101001110000111
111111100101011001110010000
111111100011110001000101010
111110100101111001010000011
111110100111010001011101000
111101100011111001110010000
111111100101000001010110011
111110100000011001010101111
111110100010111001011000101
111110100111011001101010000
111000100010101001011110111
111011100010000001101110111
111010100110000001011111101
111111100010101001011000110
111000100111010001011110101
111010100101000001110111011
111010100000101001111110011
111000100110010001101111011
111000100110010001011101111
111011100111010001110000101
111000100111011001010101110
111111100010000001110101011
111110100010000001101111011
111111100000101001110010011
111110100101111001000011010
111000100011111001010110101
111011100000010001111110101
111000100110011001010111101
111011100000110001010111101
111010100111000001101110011
111101100110010001111000011
111000100111101001010110011
111000100101011001010110111
111010100000111001101011110
111111100000101001010011110
111101100010111001011110000
111111100011010001101000110
111110100000111001101010011
111111100000110001011010101
111111100011000001110010101
111011100110101001000010111
111000100110011001101010111
111011100110000001101111010
111010100111011001101000110
111111100101010001011110000
111011100101010001111000110
111111100101011001010000110
111010100000011001110111101
111011100000101001010110111
111000100110101001011111010
111111100110000001010011101
111110100010000001111011101
111011100111010001101110000
111101100010011001111000110
111111100000011001010110101
111101100000111001010110011
111000100010011001101111110
111010100110011001101111000
111110100000101001011010111
111101100011110001111000010
111000100101110001010111011
111010100011101001110111000
111101100011110001000010111
111110100101011001000010111
111110100011000001111101010
111110100011000001010111101
111101100000010001011110111
111011100010111001101000110
111110100111011001010000101
111011100010101001111110000
111010100101000001111011110
111010100110101001111011000
111101100000110001011111010
111010100110111001011101000
111011100111110001000010101
111011100101000001111110010
111000100111101001110011010
111000100101111001011110010
111111100011110001010000101
111110100101000001011111010
111010100011101001000110111
111110100010011001000111101
111111100101000001110011010
111111100110000001011101010
111110100000111001011101010
111010100000011001111101110
111111100010011001101110000
111111100110010001011000101
111101100010011001110111000
111101100011010001000111110
111011100110000001010101111
111101100111010001011000110
111000100011101001010111110
111101100111000001110010011
111000100110111001011010101
111010100101011001000111110
111011100111000001110101010
111010100000101001011111110
111011100000111001010101110
111010100011111001000101110
111011100110000001111010101
111011100000111001101110010
111111100000110001010101011
111011100101111001000010110
111110100010101001011111000
111111100101110001000010011
111110100011111001000010101
111111100011000001101110010
111110100000011001111010101
111010100011000001101111110
111011100110101001010111000
111011100010101001000111110
111110100011101001111010000
111101100111010001110011000
111010100101111001110011000
111101100111110001011010000
111111100110011001010101000
111000100011110001010101111
111011100101110001010000111
111011100110010001111101000
111110100010111001000101011
111101100010110001000111011
111011100110111001010000101
111000100110011001111101010
111000100101011001110111010
111110100101011001010111000
111110100011010001000101111
111110100111010001000011101
111011100000101001110111010
111000100011111001110101010
111010100110011001000101111
111000100011101001111110010
111101100000011001111110010
111011100111101001110010000
111011100110111001101010000
111101100010011001000110111
111101100011000001111010110
111101100000111001011010110
111010100111110001000101011
111110100000101001010111011
111101100110010001000011111
111101100010000001111110011
111110100011111001101000010
111011100101000001010111110
111110100010111001101011000
111111100010101001110011000
111111100101110001011000010
111101100111110001010000011
111101100111000001010011110
111111100010101001000110011
111101100110000001011010111
111011100101110001000111010
111110100000011001101111010
111010100011000001111110101
111111100101000001011010110
111111100000011001101010110
111111100101010001000011110
111111100110101001011010000
111010100110101001000111011
111000100111110001011101010
111110100101010001111011000
111111100011101001010110000
111011100110101001111000010
111011100111110001101000010
111111100010011001000101110
111101100110011001111010000
111011100101111001010110000
111101100000111001110011010
111110100111000001101011010
111010100111101001011110000
111111100011101001000010110
111000100101110001011010111
111101100110111001011000010
111111100110011001000010101
111101100110111001000010011
111111100000101001011110010
111101100110000001111011010
111111100000011001110101010
111111100101011001000110010
111010100111000001011101110
111110100101111001011010000
111110100011111001010101000
111111100011000001010101110
111110100010000001011101111
111000100011111001101010110
111101100011111001000110010
111011100111000001101010110
111011100101010001000110111
111011100110010001000111101
111101100010111001000011110
111101100111011001010110000
111011100010111001000110101
111111100110010001101011000
111010100111011001000110101
111110100111101001011000010
111101100110000001010111011
111000100101011001111010110
111011100010000001111101110
111110100111101001000010011
111110100111000001011010101
111110100101010001000111011
111011100101111001110000010
111000100111011001110010101
111000100111101001011010110
111111100011010001000110101
111010100101000001011110111
111010100111101001000011110
111010100000111001011110101
111111100010000001011110101
111111100110010001000101011
111101100000011001010111110
111111100011101001110000010
111011100111000001010110101
111110100111011001000101010
111110100101011001111000010
111011100111010001000101110
111010100101111001000110011
111111100110011001101000010
111101100110010001011111000
111111100010000001101011110
111011100110111001000101010
111101100010000001011111110
111101100110111001010011000
111101100011000001110111010
111101100111011001110000010
111011100111101001010000110
111110100011101001000111010
111111100110101001000011010
111000100111011001101110010
111110100111101001010011000
111011100111110001010101000
111101100111110001000011010
111111100101110001010011000
111101100011110001010111000
111101100110011001000111010
111101100111000001011110010
111101100111011001000010110
111011100111101001000110010
111101100111010001000110011
