0000000001111000000000
0010011111111001001111
1111001001111111100100
1110100101111111010010
1001111001111100111100
0101110101111010111010
1001001111111100100111
0100101111111010010111
1110010011111111001001
0011110011111001111001
1101010111111110101011
1100111011111110011101
1011100111111101110011
0111101011111011110101
1011010001111101101000
0110110001111011011000
1100001101111110000110
0001101101111000110110
0110000111111011000011
0001011011111000101101
1010001011111101000101
0000110111111000011011
1101100001111110110000
1010111101111101011110
0111011101111011101110
0100011001111010001100
0011000101111001100010
1000010101111100001010
0010101001111001010100
1111111111111111111111
1000100011111100010001
0101000011111010100001
