0011001000
0011010001
0011100010
0011100101
0101001100
0101010010
0101010101
0101100110
0110001010
0110001101
0110010011
0110100111
1001011000
1001101100
1001110010
1001110101
1010011001
1010101010
1010101101
1010110011
1100011010
1100011101
1100101110
1100110111
