001100110010
001101010001
010101000110
010110011011
011000101001
011010010111
100101101000
100111010110
101001100100
101010111001
110010101110
110011001101
