0001000000
0001000010
0001000100
0001000101
0001001000
0001001010
0001001100
0001001101
0001010011
0001010100
0001010101
0001011001
0001011010
0001011100
0001011101
0001100000
0001100010
0001100111
0001101000
0001101010
0001101101
0001101110
0001110000
0001110001
0001110010
0001110011
0001110100
0001110101
0001110110
0001110111
0010000001
0010000010
0010000011
0010000101
0010001010
0010001011
0010001100
0010010001
0010010010
0010010011
0010010101
0010011000
0010011010
0010011011
0010011101
0010100001
0010100101
0010100110
0010101000
0010101001
0010101010
0010101011
0010101100
0010101101
0010101110
0010101111
0010110001
0010110010
0010110101
0010110111
0011000000
0011000001
0011000011
0011000100
0011001010
0011010101
0011011000
0011011001
0011011010
0011011101
0011100000
0011100001
0011100110
0011100111
0011101001
0011101010
0011101110
0011110000
0011110101
0011110111
0100000010
0100000101
0100000110
0100000111
0100001000
0100001101
0100001111
0100010001
0100010010
0100010110
0100011000
0100011001
0100011010
0100011011
0100011100
0100011101
0100011110
0100011111
0100100010
0100100101
0100100110
0100100111
0100101010
0100101100
0100101101
0100101111
0100110010
0100110011
0100110101
0100110110
0101000000
0101000100
0101000110
0101000111
0101001101
0101010001
0101010011
0101010100
0101010110
0101011001
0101011101
0101011110
0101100010
0101101010
0101101100
0101101101
0101101110
0101110010
0101110011
0101110100
0110000001
0110000011
0110000110
0110000111
0110001000
0110001011
0110001100
0110001111
0110010010
0110011000
0110011010
0110011111
0110100101
0110101011
0110101100
0110101101
0110110010
0110110011
0110110101
0110110111
0111000000
0111000001
0111000011
0111000100
0111000110
0111000111
0111001000
0111001001
0111001100
0111001110
0111010000
0111010001
0111010011
0111010111
0111011000
0111011001
0111011010
0111011101
0111100011
0111100100
0111100110
0111100111
0111101010
0111101100
0111101101
0111101110
0111110010
0111110011
0111110101
0111110111
1000001000
1000001010
1000001100
1000001101
1000010001
1000010010
1000010011
1000010101
1000011000
1000011001
1000011011
1000011100
1000100010
1000100101
1000100110
1000100111
1000101000
1000101100
1000101110
1000101111
1000110001
1000110011
1000110110
1000110111
1000111000
1000111001
1000111011
1000111100
1000111110
1000111111
1001001000
1001001010
1001001100
1001001101
1001010010
1001010011
1001010100
1001011010
1001100000
1001100101
1001100111
1001101101
1001110000
1001110011
1001110100
1001110111
1001111000
1001111001
1001111100
1001111110
1010001011
1010001100
1010001101
1010010001
1010010010
1010010011
1010010101
1010011101
1010100001
1010100010
1010100110
1010101001
1010101011
1010101100
1010101110
1010110010
1010111000
1010111001
1010111011
1010111111
1011001001
1011001010
1011001100
1011001101
1011010000
1011010010
1011010011
1011010101
1011011000
1011011001
1011011010
1011011101
1011100000
1011100001
1011100010
1011100011
1011100100
1011100101
1011100110
1011100111
1011101001
1011101101
1011101110
1011110000
1011110010
1011110111
1011111000
1011111001
1011111010
1011111101
1100001000
1100001010
1100001111
1100010001
1100010101
1100010110
1100011000
1100011001
1100011110
1100011111
1100100010
1100100101
1100100110
1100100111
1100101010
1100110101
1100111011
1100111100
1100111110
1100111111
1101001000
1101001010
1101001101
1101001110
1101010000
1101010001
1101010010
1101010011
1101010100
1101010101
1101010110
1101010111
1101011001
1101011010
1101011110
1101100010
1101100100
1101100101
1101100111
1101101010
1101101100
1101101101
1101101110
1101110011
1101110100
1101110101
1101111010
1101111100
1101111101
1101111110
1110001000
1110001001
1110001010
1110001011
1110001100
1110001101
1110001110
1110001111
1110010001
1110010010
1110010101
1110010111
1110011000
1110011101
1110011111
1110100010
1110100011
1110100101
1110100110
1110101010
1110101011
1110101100
1110110010
1110110011
1110110101
1110110111
1110111010
1110111011
1110111101
1110111111
