001011010000001011010000
110100000010110100000010
100001001100100001001100
111001000000111001000000
000010011100000010011100
000011100100000011100100
001100010010001100010010
000100100011000100100011
010000001110010000001110
100000000111100000000111
001101100000001101100000
011000000011011000000011
110010000100110010000100
000000011011000000011011
010011001000010011001000
000000101101000000101101
000000110110000000110110
000110110000000110110000
101100000001101100000001
011110000000011110000000
000001111000000001111000
001000110001001000110001
110000001001110000001001
100111000000100111000000
