111000111000
011100011100
101010101010
110001110001
001110001110
100011100011
010101010101
000111000111
