000000000100010110
000000000101010110
000000000100011110
000000100001010110
000000010100001110
000000000101011110
000000110100010001
000000000010101110
000000000110010101
000000000100110011
000000010101001110
000000100001011110
000000100000010110
000000010100000110
000000101001010110
000000011100001110
000000110101010001
000000110100011001
000000000010100110
000000000011101110
000000000111010101
000000000110011101
000000000110010100
000000000101110011
000000000100111011
000000000100110010
000000010001101110
000000010110001101
000000100001110011
000000001101010110
000000100010000110
000000001100011110
000000100000011110
000000010101000110
000000110001010101
000000110100001011
000000101110010001
000000011100110001
000000000110101011
000000100110010000
000000100011001110
000000010100110000
000000000010111101
000000101001011110
000000011101001110
000000000111011101
000000101000010110
000000011100000110
000000110010101001
000000101010001110
000000010100111001
000000100111010001
000000000010110100
000000000101010111
000000000100011111
000000100010001110
000000010000101110
000000110101011001
000000000011100110
000000000111010100
000000000110011100
000000000101111011
000000000101110010
000000000100111010
000000000011110101
000000010001100110
000000100110010001
000000010100110001
000000010111001101
000000010110001100
000000100001111011
000000100001110010
000000001100010110
000000001101011110
000000100000110011
000000010110000101
000000000011111101
000000001100010111
000000110001011101
000000110001010100
000000110101001011
000000110100001010
000000011001101110
000000110000010101
000000101111010001
000000011110001101
000000101110011001
000000011101110001
000000101001110011
000000011100111001
000000110100000011
000000000111101011
000000000110101010
000000100110011000
000000100011000110
000000010101110000
000000010101111001
000000100111011001
000000000010110101
000000000101011111
000000010001111101
000000110011001101
000000001011101110
000000000111011100
000000101000011110
000000011101000110
000000110010100001
000000110011101001
000000101011001110
000000111001010101
000000000110100011
000000111100001011
000000100111010000
000000010100111000
000000101010000110
000000000010111100
000000000011110100
000000000100010111
000000101110010000
000000011100110000
000000010000100110
000000100000110010
000000010110000100
000000110001101011
000000101001010111
000000011100001111
000000011110101001
000000100110000011
000000110101010000
000000100010110001
000000010000110101
000000010110101000
000000110100011000
000000110010000101
000000000101111010
000000100011110000
000000001110011101
000000001101010111
000000001100011111
000000100110011001
000000010101110001
000000011111001101
000000101111011001
000000010111001100
000000100001111010
000000011000101110
000000100000111011
000000010111000101
000000110010001100
000000101110001011
000000011001110101
000000010111101001
000000010001110100
000000101010111001
000000010101001111
000000000011101111
000000100001011111
000000100111001011
000000001010100110
000000001110010100
000000001101110011
000000100010111000
000000100110001010
000000001100110010
000000000010100111
000000110001011100
000000110101001010
000000110000011101
000000111001011101
000000110000010100
000000011110001100
000000011101111001
000000101001111011
000000110101000011
000000000110100010
000000101001110010
000000110100000010
000000000111101010
000000000011111100
000000011110000101
000000101000110011
000000100000010111
000000010100000111
000000001111010101
000000001100111011
000000111010001101
000000111101010001
000000111100011001
000000101011110001
000000100011111001
000000100110001011
000000010001110101
000000101001011111
000000010001111100
000000100011110001
000000100110000010
000000110011000101
000000001011100110
000000001010101110
000000011001100110
000000110011100001
000000111001010100
000000111101001011
000000000111100011
000000111100001010
000000100111011000
000000010101111000
000000101011000110
000000001101011111
000000111000010101
000000101110011000
000000011101110000
000000111100000011
000000001010101111
000000101010110000
000000010110100001
000000110001101010
000000110010001101
000000010110101001
000000101111001011
000000011001111101
000000011101001111
000000111001101011
000000110000101011
000000011111101001
000000110101011000
000000110100010000
000000010000110100
000000010110100000
000000010111101000
000000101010110001
000000100010111001
000000101011111001
000000011100000111
000000100011111000
000000100010110000
000000101111010000
000000011100111000
000000011111001100
000000011000100110
000000100000111010
000000010111000100
000000011111000101
000000110001100011
000000100001010111
000000010100001111
000000110011001100
000000101110001010
000000011110100001
000000100111000011
000000010000111101
000000010111100001
000000001111011101
000000110010000100
000000111011001101
000000111101011001
000000101110000011
000000011000110101
000000100111001010
000000011110101000
000000001110011100
000000001101110010
000000111101010000
000000111100011000
000000110011000100
000000011001101111
000000110011101000
000000100010001111
000000110000011100
000000111001011100
000000000111100010
000000101001111010
000000110101000010
000000100011000111
000000001011111101
000000111000011101
000000011110000100
000000101000111011
000000101000110010
000000011001110100
000000100000011111
000000010101000111
000000001111010100
000000001101111011
000000001110010101
000000001100111010
000000001100110011
000000111010001100
000000101000010111
000000111100010001
000000000011100111
000000000010101111
000000101011110000
000000001011101111
000000111010000101
000000111011000101
000000010000101111
000000111101001010
000000101011001111
000000110010100000
000000001110101010
000000111000010100
000000111101000011
000000111100000010
000000111100010000
000000001010100111
000000110001100010
000000101111001010
000000011001111100
000000110000100011
000000111001101010
000000110000101010
000000100111000010
000000010000111100
000000010111100000
000000101111000011
000000011101000111
000000111000101011
000000001111101011
000000010001100111
000000111011101001
000000001110100011
000000001011110100
000000101111011000
000000011101111000
000000111010101000
000000100011001111
000000011111000100
000000101010111000
000000111001100011
000000011111100001
000000001111011100
000000111011001100
000000011000111101
000000101000011111
000000101110000010
000000011110100000
000000011111101000
000000111101011000
000000001010111100
000000001010110101
000000111010100001
000000010001101111
000000110011100000
000000110010101000
000000101010001111
000000011000101111
000000100010000111
000000101011000111
000000001011110101
000000001010111101
000000001011111100
000000111011101000
000000111000011100
000000101000111010
000000001101111010
000000011000110100
000000101011111000
000000001011100111
000000111010000100
000000111011000100
000000011001100111
000000010000100111
000000001110100010
000000001010110100
000000111101000010
000000110000100010
000000101111000010
000000111000101010
000000101010000111
000000001111101010
000000001110101011
000000111010100000
000000111001100010
000000011000111100
000000111000100011
000000011111100000
000000001111100011
000000111011100001
000000111010101001
000000011000100111
000000111011100000
000000001111100010
000000111000100010
